.................................................
.#######################.........................
.#.....................#.........................
.#.....................#.........................
.#.....................#.........................
.#.....................#.........................
.#.....................#.........................
.#.....................#.........................
.#.....................#####################.....
.#.........................................#.....
.#.........................................#.....
.###########################...............#.....
...........................#...............#.....
...........................#...............#.....
...........................#...............#.....
...........................#...............#.....
...........................#...............#.....
...........................#...............#.....
...........................#################.....
.................................................
