.................................................
.###############################################.
.#.............................................#.
.#.............................................#.
.#........#.....................####.......#...#.
.#........#................................#...#.
.#......###................................#...#.
.#.........................................#...#.
.#.................................#.......#...#.
.#................................##.......#...#.
.#.................................#.......#...#.
.#.......................#......#..............##
.#.......................#......................#
.#.....##########........#..........#...........#
.#.....#.................#.......####...........#
.#.....#........##########.......#..............#
.#..............................................#
.#..............................................#
.############################################...#
............................................#####
