.................................................
.###############################################.
.#.............................................#.
.#.............................................#.
.#........#.....................####.......#...#.
.#........#................................#...#.
.#.....####................................#...#.
.#..............##########.................#...#.
.#..............#....#.............#.......#...#.
.#..............#....#............##.......#...#.
.#..............#....#.............#.......#...#.
.#.......................#......#..............#.
.#.......................#.....................#.
.#.....##########........#..........#..........#.
.#.....#.................#.......####..........#.
.#.....#........##########.......#.............#.
.#.............................................#.
.#.............................................#.
.###############################################.
.................................................
