.................................................
.#######################.........................
.#.....................#.........................
.#.....................#####################.....
.#.........................................#.....
.#.........................................#.....
.#.....................#################...#.....
.#.....................#...............#...#.....
.#.....................#################...#.....
.#.........................................#.....
.#.........................................#.....
.#...###################...................#.....
.#................#....#...................#.....
.#................#....#...................#.....
.#................#....#...................#.....
.#................#....#...................#.....
.#................#....#####...............#.....
.##################........#...............#.....
...........................#################.....
.................................................
